####################
####################
####################
#        ##    #   #
#                  #
#                  #
#   #       #      #
#@  #   # O # O P  #
####################
####################
