######################
##   ##           ####
##                 ###
#@                  ##
##                   #
##           #  O    #
##           #O OO P #
######   #############
######  O#############
######################
