###################
# ###             #
#  #              #
#                O#
#               OO#
# ###    P   #O ###
# ###    #  #######
# ###OO ##  #######
#@######## ########
###################
