########################
################## #####
#################   ####
####### ########     ###
######   ######       ##
###       ####         #
##         ##          #
##                    O#
##                   OO#
##               P   ###
##    #          #   ###
#@    # O        #######
##### # O   O  #########
##### # O # #O #########
##### ##################
########################
