######################
#####   ####         #
#                    #
#                    #
#                    #
#     #              #
#     #              #
#     #OOOO          #
#@   #######P        #
## ########## #     O#
## ########## ##   OO#
## ########## ##  OOO#
############# ########
######################
