#####################
##  #############   #
##                  #
#@                  #
##                  #
##                OO#
##OO        #  O  ###
##OOO       #POOO ###
##OOOO      ##### ###
######    ###########
######   O###########
####### #############
#####################
