########################
## ###     ###  ###   ##
##  ##      ##   ##    #
##   #       #    #    #
##                    O#
##                    O#
##                   OO#
#@   O               ###
##   # O     #    ## ###
##   # O    ## O P######
###  # OOO  ## OOO######
###  ###### ############
#### ###################
########################
