###########################
#   #######    ###       ##
#    #####     ##         #
#O    ###    # #     ###  #
#OO         ##      ## #  #
####       ##          #@ #
#####            ##    ## #
###    O #      #  #      #
###    O# #    #   #      #
##   ###   #    #  #     O#
##      # #      ##     OO#
#        #           ######
#            O            #
#    O      ###          O#
#   ###                 OO#
#        O       O  P  OOO#
###########################
