####################
########   #########
#######     ########
######       ##    #
#####     O        #
####      OO      O#
###       ###    OO#
##            P ####
#             O    #
#@           ###   #
##    ##   #      O#
##    ##O  ##   ####
##    #######  #####
####  ####### ######
#### ###############
####################
