###########################
###           #         ###
####O       OO#O   OOO O###
#  ##  #   #####  O### ## #
#   #  ##        ### ###  #
#   ##  ##OOOO            #
#@       #######          #
##        #   ###        ##
##     O   # #  ##        #
##     #    #    ##       #
#####  ##             #####
########      P           #
####          #           #
####         ##    ########
####        ##           ##
####          O         O##
####O    ###########   OO##
####OO  ############# OOO##
###########################
