#############################
#  #   #                    #
#     O#OO            ##### #
#O   ### O##     O  ##  @ # #
#OO    ###      O       # # #
###  OO#     #PO          # #
#   ####      #  ###   ###  #
#O            # #      #  O #
#OO       ### # #O    #  ####
#### O   ###  # ##O  # O #  #
#           O ###  O#   #   #
#   O     OO #   ####       #
#    #########        ##### #
#              O   O##    # #
####           O   #    OO# #
#O##   #    #          #### #
##O### #    #   OOO O       #
#O#O#O##    #        OOO    #
#############################
