############
##    ######
##    ######
##P      ###
#####    ###
##      @###
##    ######
##       ###
#####    ###
##     OO###
##    ######
##OO     ###
#####    ###
##     OO###
##    ######
##OO     ###
#####    ###
##### OOO###
############
