###############
#      ########
#O    O########
# O  O  #######
## O  O   #####
#@  #####  ####
##    P       #
## # OOO #   O#
##  #   #   OO#
##   # #   ####
###   #   #####
####     ######
#####   #######
###############
